11111111111111111111
10000000000000000001
10000000000000000001
10000000000000000001
10000000000000000001
10000020202000000001
10000020202000000001
10000020202000000001
10000000000000000001
10000000000000000001
10000003333333000001
10000003000000000001
10000000000000000001
10000000000000000001
10000000000000000001
10000000000000000001
10000000000000000001
10000000000000000001
10000000000000000001
11111111111111111111





